BatchNum	1
PatchModel	0
Resolution	100
LandType	9
MaxHabitats	1
SpeciesDist	0
DistResolution	100
Reproduction	0
RepSeasons	1
StageStruct	0
Stages	1
Transfer	0
ParameterFile	ParameterFile_ex3.tsv
LandFile	LandFile_ex3.tsv
StageStructFile	NULL
EmigrationFile	EmigrationFile_ex3.tsv
TransferFile	TransferFile_ex3.tsv
SettlementFile	SettlementFile_ex3.tsv
GeneticsFile	GeneticsFile_ex3.tsv
TraitsFile	TraitsFile_ex3.tsv
InitialisationFile	InitialisationFile_ex3.tsv
